NO ./textures/wall.xpm
SO ./textures/WALL69.xpm
WE ./textures/WALL0.xpm
EA ./textures/WALL73.xpm
S ./textures/sprite.xpm
F 255,255,255
R 700 700
C 0,0,0

   111111      111111
   10S001      100201
   10000111    100001
   10000101     100001
   102000111111100001111111111111111111111111111111111
   100000000000000001000000000000000000000000000000001
   100000000000000001000000000000000000000000000000001
   100000000000000001000000000000000000000000000000001
   10000000000000000000000000000000000000000020000001
   10000000000000000000000000002000000000000000000001
   10000000000000000000000000000000000000000000000001
   10000000000000000000000000000000000000000020000001
   10000000000000000000000000000000000000000000000001
   100000000000000000000000000000200000000000000000001
   10020000000020000000000000000000000000000000000001
   10000000000000000000000000000000000000000020000001
   10000000000000000000000000000000000000000000000001
   10000000000020000000000000020000000000000000000001
   10020000000000000000000000000000000000000000000001
   10000000000000000000000000000000000000000020000001
   10000000000000000000000000000000000000000000000001
   10000000000020000000000000020000000000000020000001
   10020000000000000000000000000000000000000000000001
   1000000000000000000000000000000000000000000000000111
    100000000000000001000000000000000000000000000000001
   100000000000000001000000000000000000000000000000001
   100000000000000001000000000000000000000000000000001
   10000000000000000000000000000000000000000020000001
   10000000000000000000000000002000000000000000000001
   10000000000000000000000000000000000000000000000001
   10000000000000000000000000000000000000000020000001
   10000000000000000000000000000000000000000000000001
   100000000000000000000000000000200000000000000000001
   10020000000020000000000000000000000000000000000001
   10000000000000000000000000000000000000000020000001
   10000000000000000000000000000000000000000000000001
   10000000000020000000000000020000000000000000000001
   10020000000000000000000000000000000000000000000001
   10000000000000000000000000000000000000000020000001
   10000000000000000000000000000000000000000000000001
   10000000000020000000000000020000000000000020000001
   10020000000000000000000000000000000000000000000001
   1000000000000000000000000000000000000000000000000111
    100000000000000001000000000000000000000000000000001
   100000000000000001000000000000000000000000000000001
   100000000000000001000000000000000000000000000000001
   10000000000000000000000000000000000000000020000001
   10000000000000000000000000002000000000000000000001
   10000000000000000000000000000000000000000000000001
   10000000000000000000000000000000000000000020000001
   10000000000000000000000000000000000000000000000001
   100000000000000000000000000000200000000000000000001
   10020000000020000000000000000000000000000000000001
   10000000000000000000000000000000000000000020000001
   10000000000000000000000000000000000000000000000001
   10000000000020000000000000020000000000000000000001
   10020000000000000000000000000000000000000000000001
   10000000000000000000000000000000000000000020000001
   10000000000000000000000000000000000000000000000001
   10000000000020000000000000020000000000000020000001
   10020000000000000000000000000000000000000000000001
   10000000000000000000000000000000000000000000000001
   100000000000000001000000000000000000000000000000001
   100000000000000001000000000000000000000000000000001
   100000000000000001000000000000000000000000000000001
   10000000000000000000000000000000000000000020000001
   10000000000000000000000000002000000000000000000001
   10000000000000000000000000000000000000000000000001
   10000000000000000000000000000000000000000020000001
   10000000000000000000000000000000000000000000000001
   100000000000000000000000000000200000000000000000001
   10020000000020000000000000000000000000000000000001
   10000000000000000000000000000000000000000020000001
   10000000000020000000000000020000000000000000000001
   10020000000000000000000000000000000000000000000001
   10000000000000000000000000000000000000000020000001
   10000000000000000000000000000000000000000000000001
   10000000000020000000000000020000000000000020000001
   10020000000000000000000000000000000000000000000001
   10000000000000000000000000000000000000000000000001
   100000000000000001000000000000000000000000000000001
   100000000000000001000000000000000000000000000000001
   100000000000000001000000000000000000000000000000001
   10000000000000000000000000000000000000000020000001
   10000000000000000000000000002000000000000000000001
   10000000000000000000000000000000000000000000000001
   10000000000000000000000000000000000000000020000001
   10000000000000000000000000000000000000000000000001
   100000000000000000000000000000200000000000000000001
   10020000000020000000000000000000000000000000000001
   10000000000000000000000000000000000000000020000001
   10000000000000000000000000000000000000000000000001
   10000000000020000000000000020000000000000000000001
   10020000000000000000000000000000000000000000000001
   10000000000000000000000000000000000000000020000001
   10000000000000000000000000000000000000000000000001
   10000000000020000000000000020000000000000020000001
   10020000000000000000000000000000000000000000000001
   10000000000000000000000000000000000000000000000001
   100000000000000001000000000000000000000000000000001
   100000000000000001000000000000000000000000000000001
   100000000000000001000000000000000000000000000000001
   10000000000000000000000000000000000000000020000001
   10000000000000000000000000002000000000000000000001
   10000000000000000000000000000000000000000000000001
   10000000000000000000000000000000000000000020000001
   10000000000000000000000000000000000000000000000001
   100000000000000000000000000000200000000000000000001
   10020000000020000000000000000000000000000000000001
   10000000000000000000000000000000000000000020000001
   10000000000000000000000000000000000000000000000001
   10000000000020000000000000020000000000000000000001
   10020000000000000000000000000000000000000000000001
   10000000000000000000000000000000000000000020000001
   10000000000000000000000000000000000000000000000001
   10000000000020000000000000020000000000000020000001
   10020000000000000000000000000000000000000000000001
   10000000000000000000000000000000000000000000000001
   100000000000000001000000000000000000000000000000001
   100000000000000001000000000000000000000000000000001
   100000000000000001000000000000000000000000000000001
   10000000000000000000000000000000000000000020000001
   10000000000000000000000000002000000000000000000001
   10000000000000000000000000000000000000000000000001
   10000000000000000000000000000000000000000020000001
   10000000000000000000000000000000000000000000000001
   100000000000000000000000000000200000000000000000001
   10020000000020000000000000000000000000000000000001
   10000000000000000000000000000000000000000020000001
   10000000000000000000000000000000000000000000000001
   10000000000020000000000000020000000000000000000001
   10020000000000000000000000000000000000000000000001
   10000000000000000000000000000000000000000020000001
   10000000000000000000000000000000000000000000000001
   10000000000020000000000000020000000000000020000001
   10020000000000000000000000000000000000000000000001
   10000000000000000000000000000000000000000000000001
   100000000000000001000000000000000000000000000000001
   100000000000000001000000000000000000000000000000001
   100000000000000001000000000000000000000000000000001
   10000000000000000000000000000000000000000020000001
   10000000000000000000000000002000000000000000000001
   10000000000000000000000000000000000000000000000001
   10000000000000000000000000000000000000000020000001
   10000000000000000000000000000000000000000000000001
   100000000000000000000000000000200000000000000000001
   10020000000020000000000000000000000000000000000001
   10000000000000000000000000000000000000000020000001
   10000000000000000000000000000000000000000000000001
   10000000000020000000000000020000000000000000000001
   10020000000000000000000000000000000000000000000001
   10000000000000000000000000000000000000000020000001
   10000000000000000000000000000000000000000000000001
   10000000000020000000000000020000000000000020000001
   10020000000000000000000000000000000000000000000001
   10000000000000000000000000000000000000000000000001
   100000000000000001000000000000000000000000000000001
   100000000000000001000000000000000000000000000000001
   100000000000000001000000000000000000000000000000001
   10000000000000000000000000000000000000000020000001
   10000000000000000000000000002000000000000000000001
   10000000000000000000000000000000000000000000000001
   10000000000000000000000000000000000000000020000001
   10000000000000000000000000000000000000000000000001
   100000000000000000000000000000200000000000000000001
   10020000000020000000000000000000000000000000000001
   10000000000000000000000000000000000000000020000001
   10000000000000000000000000000000000000000000000001
   10000000000020000000000000020000000000000000000001
   10020000000000000000000000000000000000000000000001
   10000000000000000000000000000000000000000020000001
   10000000000000000000000000000000000000000000000001
   10000000000020000000000000020000000000000020000001
   10020000000000000000000000000000000000000000000001
   10000000000000000000000000000000000000000000000001
   100000000000000001000000000000000000000000000000001
   100000000000000001000000000000000000000000000000001
   100000000000000001000000000000000000000000000000001
   10000000000000000000000000000000000000000020000001
   10000000000000000000000000002000000000000000000001
   10000000000000000000000000000000000000000000000001
   10000000000000000000000000000000000000000020000001
   10000000000000000000000000000000000000000000000001
   100000000000000000000000000000200000000000000000001
   10020000000020000000000000000000000000000000000001
   10000000000000000000000000000000000000000020000001
   10000000000000000000000000000000000000000000000001
   10000000000020000000000000020000000000000000000001
   10020000000000000000000000000000000000000000000001
   10000000000000000000000000000000000000000020000001
   10000000000000000000000000000000000000000000000001
   10000000000020000000000000020000000000000020000001
   10020000000000000000000000000000000000000000000001
   10000000000000000000000000000000000000000000000001
   100000000000000001000000000000000000000000000000001
   100000000000000001000000000000000000000000000000001
   100000000000000001000000000000000000000000000000001
   10000000000000000000000000000000000000000020000001
   10000000000000000000000000002000000000000000000001
   10000000000000000000000000000000000000000000000001
   10000000000000000000000000000000000000000020000001
   10000000000000000000000000000000000000000000000001
   100000000000000000000000000000200000000000000000001
   10020000000020000000000000000000000000000000000001
   10000000000000000000000000000000000000000020000001
   10000000000000000000000000000000000000000000000001
   10000000000020000000000000020000000000000000000001
   10020000000000000000000000000000000000000000000001
   10000000000000000000000000000000000000000020000001
   10000000000000000000000000000000000000000000000001
   10000000000020000000000000020000000000000020000001
   10020000000000000000000000000000000000000000000001
   10000000000000000000000000000000000000000000000001
   100000000000000001000000000000000000000000000000001
   100000000000000001000000000000000000000000000000001
   100000000000000001000000000000000000000000000000001
   10000000000000000000000000000000000000000020000001
   10000000000000000000000000002000000000000000000001
   10000000000000000000000000000000000000000000000001
   10000000000000000000000000000000000000000020000001
   10000000000000000000000000000000000000000000000001
   100000000000000000000000000000200000000000000000001
   10020000000020000000000000000000000000000000000001
   10000000000000000000000000000000000000000020000001
   10000000000000000000000000000000000000000000000001
   10000000000020000000000000020000000000000000000001
   10020000000000000000000000000000000000000000000001
   10000000000000000000000000000000000000000020000001
   10000000000000000000000000000000000000000000000001
   10000000000020000000000000020000000000000020000001
   10020000000000000000000000000000000000000000000001
   10000000000000000000000000000000000000000000000001
   100000000000000001000000000000000000000000000000001
   100000000000000001000000000000000000000000000000001
   100000000000000001000000000000000000000000000000001
   10000000000000000000000000000000000000000020000001
   10000000000000000000000000002000000000000000000001
   10000000000000000000000000000000000000000000000001
   10000000000000000000000000000000000000000020000001
   10000000000000000000000000000000000000000000000001
   100000000000000000000000000000200000000000000000001
   10020000000020000000000000000000000000000000000001
   10000000000000000000000000000000000000000020000001
   10000000000000000000000000000000000000000000000001
   10000000000020000000000000020000000000000000000001
   10020000000000000000000000000000000000000000000001
   10000000000000000000000000000000000000000020000001
   10000000000000000000000000000000000000000000000001
   10000000000020000000000000020000000000000020000001
   10020000000000000000000000000000000000000000000001
   10000000000000000000000000000000000000000000000001
   100000000000000001000000000000000000000000000000001
   100000000000000001000000000000000000000000000000001
   100000000000000001000000000000000000000000000000001
   10000000000000000000000000000000000000000020000001
   10000000000000000000000000002000000000000000000001
   10000000000000000000000000000000000000000000000001
   10000000000000000000000000000000000000000020000001
   10000000000000000000000000000000000000000000000001
   100000000000000000000000000000200000000000000000001
   10020000000020000000000000000000000000000000000001
   10000000000000000000000000000000000000000020000001
   10000000000000000000000000000000000000000000000001
   10000000000020000000000000020000000000000000000001
   10020000000000000000000000000000000000000000000001
   10000000000000000000000000000000000000000020000001
   10000000000000000000000000000000000000000000000001
   10000000000020000000000000020000000000000020000001
   10020000000000000000000000000000000000000000000001
   10000000000000000000000000000000000000000000000001
   100000000000000001000000000000000000000000000000001
   100000000000000001000000000000000000000000000000001
   100000000000000001000000000000000000000000000000001
   10000000000000000000000000000000000000000020000001
   10000000000000000000000000002000000000000000000001
   10000000000000000000000000000000000000000000000001
   10000000000000000000000000000000000000000020000001
   10000000000000000000000000000000000000000000000001
   100000000000000000000000000000200000000000000000001
   10020000000020000000000000000000000000000000000001
   10000000000000000000000000000000000000000020000001
   10000000000000000000000000000000000000000000000001
   10000000000020000000000000020000000000000000000001
   10020000000000000000000000000000000000000000000001
   10000000000000000000000000000000000000000020000001
   10000000000000000000000000000000000000000000000001
   10000000000020000000000000020000000000000020000001
   10020000000000000000000000000000000000000000000001
   10000000000000000000000000000000000000000000000001
   100000000000000001000000000000000000000000000000001
   100000000000000001000000000000000000000000000000001
   100000000000000001000000000000000000000000000000001
   10000000000000000000000000000000000000000020000001
   10000000000000000000000000002000000000000000000001
   10000000000000000000000000000000000000000000000001
   10000000000000000000000000000000000000000020000001
   10000000000000000000000000000000000000000000000001
   100000000000000000000000000000200000000000000000001
   10020000000020000000000000000000000000000000000001
   10000000000000000000000000000000000000000020000001
   10000000000000000000000000000000000000000000000001
   10000000000020000000000000020000000000000000000001
   10020000000000000000000000000000000000000000000001
   10000000000000000000000000000000000000000020000001
   10000000000000000000000000000000000000000000000001
   10000000000020000000000000020000000000000020000001
   10020000000000000000000000000000000000000000000001
   10000000000000000000000000000000000000000000000001
   100000000000000001000000000000000000000000000000001
   100000000000000001000000000000000000000000000000001
   100000000000000001000000000000000000000000000000001
   10000000000000000000000000000000000000000020000001
   10000000000000000000000000002000000000000000000001
   10000000000000000000000000000000000000000000000001
   10000000000000000000000000000000000000000020000001
   10000000000000000000000000000000000000000000000001
   100000000000000000000000000000200000000000000000001
   10020000000020000000000000000000000000000000000001
   10000000000000000000000000000000000000000020000001
   10000000000000000000000000000000000000000000000001
   10000000000000000000000000000000000000000000000001
   10000000000020000000000000020000000000000000000001
   10020000000000000000000000000000000000000000000001
   10000000000000000000000000000000000000000020000001
   10000000000000000000000000000000000000000000000001
   10000000000020000000000000020000000000000020000001
   10020000000000000000000000000000000000000000000001
   10000000000000000000000000000000000000000000000001
   10000000000020000111111111111111111111111111111111
   100000000000000001
   100020000000000001
   100000000000000001
   100000000000000001
   100000000000200001
   100000000000000001
   100000000000000001
   100000000000000001
   100000020000000001
   100000000000000001
   100201111111120001
   120001      100001
   100001      100201
   111111      111111

